WWWWWWW
WD.L.RW
W.WCU.W
WWW.S.W
WWWWWWW
